Incident_ID,Incident Date,State,City Or County,Address,# Killed,# Injured,TotalVictim,Month/Year,Year
97407,2016-01-2014,Oklahoma,Ardmore,H St NE and Martin Luther King Blvd,2,5,7,201401,2014
95550,12-01-2014,Alabama,Huntsville,University Drive,0,5,5,201401,2014
95579,12-01-2014,Illinois,Elgin,300 block of North Street,0,5,5,201401,2014
97365,2016-01-2014,Utah,Spanish Fork,37 N. 630 West,5,0,5,201401,2014
113665,27-01-2014,Washington,Seattle,2nd Avenue South and South Main Street,1,4,5,201401,2014
95500,12-01-2014,Louisiana,Tallulah,3600 block of Highway 80 W,0,6,6,201401,2014
98836,21-01-2014,New Jersey,Newark,Springfield Avenue ,2,3,5,201401,2014
100434,25-01-2014,Illinois,Chicago,S Union Ave and W 51st St,1,4,5,201401,2014
107673,2016-02-2014,Indiana,Fort Wayne,Lafayette Street and East Tillman Road,0,5,5,201402,2014
107519,2016-02-2014,Texas,Dallas,2600 block of South Harwood Street,1,7,8,201402,2014
107433,2016-02-2014,Florida,Jacksonville,1187 S. Edgewood Ave.,1,4,5,201402,2014
107417,2016-02-2014,Florida,Orlando (Pine Hills),4500 block of Charlene Terrace,1,6,7,201402,2014
107403,2015-02-2014,Nevada,Las Vegas,Sahara and Maryland ,0,5,5,201402,2014
106394,12-02-2014,Indiana,Gary,2220 block of Broadway,0,5,5,201402,2014
104721,7-02-2014,Florida,Miami,Northwest 41st Street and 9th Avenue ,0,5,5,201402,2014
109957,25-02-2014,Virginia,Glade Spring,Graceland Lane,5,1,6,201402,2014
108649,20-02-2014,California,Alturas,300 W 1st St,4,2,6,201402,2014
103698,3-02-2014,Indiana,Franklin,2100 block of Bridlewood Dr,3,2,5,201402,2014
108659,2016-02-2014,Texas,Fort Worth, 115 NW 25th St.,1,4,5,201402,2014
111095,1-03-2014,Pennsylvania,Pittsburgh,Hamilton Avenue,1,4,5,201403,2014
112415,5-03-2014,South Carolina,Pelzer,Law Street,3,2,5,201403,2014
113214,8-03-2014,Illinois,Chicago,4900 West Race Ave,0,6,6,201403,2014
113247,9-03-2014,Texas,Austin, 4900 block of West Race Avenue,0,6,6,201403,2014
117914,23-03-2014,California,San Francisco,Turk and Taylor,0,7,7,201403,2014
120303,30-03-2014,North Carolina,Charlotte,4300 Sunset Road,0,5,5,201403,2014
120621,30-03-2014,Mississippi,Starkville,,0,5,5,201403,2014
128871,25-04-2014,Tennessee,Memphis,2000 Chelsea Avenue,2,3,5,201404,2014
121031,2-04-2014,Texas,Fort Hood,Motor Pool Road and Tank Destroyer Boulevard,4,16,20,201404,2014
122136,5-04-2014,Illinois,Chicago,4300 W Wilcox Street,1,5,6,201404,2014
127045,20-04-2014,Illinois,Montgomery,1300 block of Jackson St,0,6,6,201404,2014
127413,20-04-2014,Illinois,Chicago,6600 South Michigan Ave,0,5,5,201404,2014
129730,27-04-2014,New York,Troy,Fourth Street,0,5,5,201404,2014
130232,29-04-2014,Georgia,Kennesaw,1675 Airport Road,1,6,7,201404,2014
140185,23-05-2014,Louisiana,New Orleans,6200 block of Eads Street,1,7,8,201405,2014
138282,23-05-2014,California,Goleta (Isla Vista),840 Embarcadero Del Norte,4,8,12,201405,2014
136163,2017-05-2014,District of Columbia,Washington,2200 block of Adams Place NE,0,5,5,201405,2014
135904,2018-05-2014,Ohio,Sandusky,1643 Cleveland Rd,0,7,7,201405,2014
134823,13-05-2014,Georgia,Atlanta,Panther Trail and Childress Drive,0,5,5,201405,2014
134238,11-05-2014,Tennessee,Memphis,2517 Shasta,0,7,7,201405,2014
156823,10-05-2014,California,Sacramento,3031 Guadalajara Way,1,6,7,201405,2014
134052,10-05-2014,Georgia,Decatur,Shamrock Dr,2,3,5,201405,2014
131998,3-05-2014,Arkansas,Jonesboro,2201 Moore Rd,4,4,8,201405,2014
150299,24-06-2014,Florida,Miami,Northwest 12th Avenue and 65th Street,2,7,9,201406,2014
152960,28-06-2014,California,Antioch,5500 Cedar Point Way,0,7,7,201406,2014
152693,29-06-2014,California,Los Angeles,1100 block of North Vermont Avenue,1,5,6,201406,2014
152468,29-06-2014,Louisiana,New Orleans,700 block of Bourbon St,1,9,10,201406,2014
151659,26-06-2014,Wisconsin,Milwaukee,24th and Locust,0,5,5,201406,2014
151475,25-06-2014,Massachusetts,Lowell,Midland Street,0,5,5,201406,2014
150344,21-06-2014,Tennessee,Memphis,2119 East Alcy Road,0,5,5,201406,2014
144565,8-06-2014,Alabama,Opp,611 Hardin Street,1,4,5,201406,2014
143723,7-06-2014,South Carolina,Moncks Corner,Tish Lane,1,5,6,201406,2014
156245,9-06-2014,New Jersey,Paterson,Rosa Parks Boulevard and Godwin Avenue,0,6,6,201406,2014
142076,2-06-2014,Illinois,Chicago,2660 E. 79th St,0,7,7,201406,2014
141382,1-06-2014,Illinois,Chicago,West Ferdinand Street and North Lavergne Avenue ,1,5,6,201406,2014
142818,3-06-2014,Georgia,Atlanta,Auburn Avenue,1,4,5,201406,2014
158589,13-07-2014,Connecticut,Stamford,84 West Park Place,0,5,5,201407,2014
161302,21-07-2014,New Jersey,Irvington,36 Welland Avenue,0,6,6,201407,2014
163874,25-07-2014,Illinois,Chicago,700 South California Avenue,1,6,7,201407,2014
164513,26-07-2014,Maine,Saco,35 Water Street,5,0,5,201407,2014
165089,27-07-2014,Missouri,Saint Louis,2000 block of East John Avenue,0,5,5,201407,2014
165856,28-07-2014,Pennsylvania,Philadelphia,4900 block of North Front Street,1,4,5,201407,2014
176329,30-07-2014,North Carolina,Hope Mills,926 Bramblegate Rd,2,3,5,201407,2014
158387,2014-07-2014,California,Sacramento,Fulton Avenue ,1,4,5,201407,2014
158306,13-07-2014,Washington,Skyway,12600 Renton Avenue South ,0,5,5,201407,2014
158055,5-07-2014,Illinois,Centreville,4700 Piggott Avenue,0,5,5,201407,2014
157857,12-07-2014,California,Pasadena,1700 block of Summit Avenue,3,2,5,201407,2014
156834,2-07-2014,Pennsylvania,Chester,1400 block of West Congress Street,0,5,5,201407,2014
163930,26-07-2014,Georgia,Sylvester,Royal Street,0,8,8,201407,2014
156670,9-07-2014,Texas,Spring,711 Leaflet Ln,6,1,7,201407,2014
156468,8-07-2014,Rhode Island,Providence,35 March Street,0,5,5,201407,2014
155943,7-07-2014,California,San Bernardino,312  E Baseline Street ,1,4,5,201407,2014
154971,5-07-2014,Oregon,Portland,333 SE 122ND Ave,1,4,5,201407,2014
154844,4-07-2014,Virginia,Norfolk,1722 Thurgood Street,0,5,5,201407,2014
154834,5-07-2014,Virginia,Norfolk,861 W. 36th Street,0,7,7,201407,2014
154803,5-07-2014,Texas,Houston,1700 Almeda-Genoa,0,6,6,201407,2014
154721,5-07-2014,Indiana,Indianapolis,Broad Ripple Avenue,0,7,7,201407,2014
171802,9-08-2014,Minnesota,Minneapolis,400 3rd Ave N,1,8,9,201408,2014
172180,10-08-2014,California,Moreno Valley,16300 block of Heather Glen Road ,0,7,7,201408,2014
172205,10-08-2014,District of Columbia,Washington,50 block of N St SW,0,6,6,201408,2014
172288,10-08-2014,Georgia,Wrightsville,2455 Idylwild Dr,0,6,6,201408,2014
180007,24-08-2014,California,San Fernando,1400 block of Celis Street ,3,4,7,201408,2014
173628,12-08-2014,Georgia,Cartersville,Brent Cir,2,3,5,201408,2014
175788,2016-08-2014,Utah,Salt Lake City,122 Pierpont Avenue,0,6,6,201408,2014
169326,4-08-2014,Georgia,Atlanta,1100 block of Joseph E. Boone Boulevard NW,0,5,5,201408,2014
183432,31-08-2014,California,Livermore,200 block of South Q Street ,0,5,5,201408,2014
172304,10-08-2014,Louisiana,New Orleans,5400 block of Burgundy St,2,5,7,201408,2014
169024,3-08-2014,Tennessee,Columbia,East 9th Street and Bridge Street,0,5,5,201408,2014
178425,20-08-2014,Tennessee,Memphis,1400 block of Briarcrest Lane,0,5,5,201408,2014
168786,3-08-2014,Missouri,Saint Louis,5200 block of Thekla ,0,5,5,201408,2014
168307,2-08-2014,Pennsylvania,Pittsburgh,Penn Avenue and 29th Street,1,5,6,201408,2014
168169,2-08-2014,Massachusetts,New Bedford,Acushnet Avenue,0,7,7,201408,2014
168844,3-08-2014,Virginia,Culpeper,4400 block of Rixeyville Road,5,0,5,201408,2014
168551,3-08-2014,Texas,Humble,3403 FM 1960,0,7,7,201408,2014
185430,3-09-2014,California,Los Angeles,East 27th and Stanford ,0,6,6,201409,2014
190599,2014-09-2014,Alaska,Anchorage,225 E Fifth,0,6,6,201409,2014
191416,2015-09-2014,Louisiana,New Orleans,Chef Menteur Highway and Dale Street,0,5,5,201409,2014
192851,2018-09-2014,Florida,Bell,NW 30th Street and NW 39th Terrace,8,0,8,201409,2014
197287,27-09-2014,Missouri,Saint Louis,2000 block East John Avenue,0,5,5,201409,2014
197384,28-09-2014,Florida,Miami,NW 7th Ave and NW 64th Street,0,15,15,201409,2014
189562,11-09-2014,Michigan,Detroit,14000 block of Patton,1,7,8,201409,2014
186488,6-09-2014,Georgia,Macon,576 Poplar Street,0,5,5,201409,2014
198051,29-09-2014,South Carolina,Walterboro,29 Sandy Dam Lane,1,7,8,201409,2014
198064,26-09-2014,South Carolina,Darlington County,600 block of Turner Road,1,4,5,201409,2014
185393,4-09-2014,Michigan,Flint,2400 block of Martin Luther King Boulevard,0,5,5,201409,2014
184507,2-09-2014,California,Highland,25000 block of Fifth Street ,0,5,5,201409,2014
185196,2-09-2014,Mississippi,Jackson,3622 Medgar Evers Boulevard,2,3,5,201409,2014
212884,29-10-2014,Tennessee,Memphis,Yale Road and Ramill Road,0,5,5,201410,2014
210363,24-10-2014,Washington,Marysville,5611 108th St NE,5,1,6,201410,2014
204236,11-10-2014,New York,Utica,222 Bleecker Street,0,5,5,201410,2014
201052,5-10-2014,Michigan,Detroit,East 7 Mile Road and Sherwood Street,1,5,6,201410,2014
205726,2014-10-2014,Georgia,Peachtree Corners,6505 Bannor Lane,3,2,5,201410,2014
217831,8-11-2014,California,Pomona,499 E. Arrow Highway,0,5,5,201411,2014
225036,26-11-2014,California,San Francisco,Mission and 13th streets,0,6,6,201411,2014
224746,2016-11-2014,Texas,El Paso,115 S. Durango,0,6,6,201411,2014
224131,23-11-2014,Colorado,Denver,Federal Boulevard and 16th Avenue,1,4,5,201411,2014
223799,22-11-2014,South Dakota,Sisseton,Fourth Avenue,4,1,5,201411,2014
223651,22-11-2014,Ohio,Cleveland,1443 E 92nd St,4,1,5,201411,2014
223582,21-11-2014,Pennsylvania,Pittsburgh,600 block of Miller Avenue,0,6,6,201411,2014
221554,2016-11-2014,Ohio,Akron,1891 E Market St,1,4,5,201411,2014
226018,27-11-2014,Texas,Georgetown,Pvt Rd 934,2,3,5,201411,2014
225903,29-11-2014,Georgia,Atlanta,1600 block of Richmond Avenue,3,2,5,201411,2014
226534,30-11-2014,Tennessee,Chattanooga,2412 East 13th Street ,0,5,5,201411,2014
226983,2-12-2014,Virginia,Newport News,6128 Jefferson Ave ,0,5,5,201412,2014
227011,2-12-2014,Missouri,Saint Louis,6000 block of Virginia Avenue,1,5,6,201412,2014
263376,2014-12-2014,Florida,Miami,1311 Northwest 2nd Avenue,1,4,5,201412,2014
267721,22-12-2014,Illinois,Chicago,5700 block of South Green Street,0,5,5,201412,2014
266424,21-12-2014,Illinois,Calumet City,600 block of Escanba,1,8,9,201412,2014
263382,13-12-2014,Florida,Tampa,810 E. Skagway Ave.,0,5,5,201412,2014
263556,2015-12-2014,Pennsylvania,Lansdale,100 block of West 5th St,7,0,7,201412,2014
268910,21-12-2014,Mississippi,Waynesboro,Central Avenue,1,4,5,201412,2014
282186,22-12-2014,New York,Webster,191 Lake Road,4,2,6,201412,2014
283041,24-01-2015,Nebraska,Omaha,3402 Parker St,3,5,8,201501,2015
282956,24-01-2015,New York,Arverne (Queens),231-11 148th Avenue,4,1,5,201501,2015
273965,2-01-2015,Georgia,Savannah,500 block of W. 54th Street,1,4,5,201501,2015
281039,2019-01-2015,Texas,San Antonio,1000 block of Gibbs St.,2,5,7,201501,2015
276845,11-01-2015,North Carolina,Hope Mills,1900 block of Gumberry Road,2,5,7,201501,2015
276766,11-01-2015,California,San Jose,3840 Monterey Hwy,0,5,5,201501,2015
283115,23-01-2015,Massachusetts,Boston,954 Parker Street,0,6,6,201501,2015
273535,4-01-2015,Virginia,Roanoke,3634 Shenandoah Ave NW,2,4,6,201501,2015
272016,1-01-2015,Tennessee,Memphis,Interstate 240 and Poplar Avenue,0,5,5,201501,2015
298773,13-01-2015,Virginia,Portsmouth,4100 block of Portsmouth Boulevard,0,5,5,201501,2015
296215,22-02-2015,Texas,Killeen,1706 Godman St.,4,1,5,201502,2015
296121,22-02-2015,Georgia,Clarkesville,281 Lower Pond Court,3,2,5,201502,2015
293883,2015-02-2015,California,Long Beach,200 block of W. 14th Street,0,5,5,201502,2015
290510,8-02-2015,Tennessee,Friendship,251 Dupree Rd,0,6,6,201502,2015
290098,6-02-2015,Oklahoma,Tulsa,1219 N. Sheridan Road,1,4,5,201502,2015
289811,7-02-2015,Georgia,Douglasville,3640 Willow Tree Circle,5,2,7,201502,2015
289146,5-02-2015,Ohio,Beachwood (Warrensville Heights),Harvard Road,3,3,6,201502,2015
298122,26-02-2015,Missouri,Tyrone,18279 Highway H,8,1,9,201502,2015
287031,1-02-2015,New York,New York (Manhattan),3345 Broadway,1,4,5,201502,2015
287529,1-02-2015,New York,Syracuse,1217 West Fayette Street,0,6,6,201502,2015
299344,1-03-2015,Michigan,Detroit,9855 Chalmers St,1,5,6,201503,2015
311348,22-03-2015,New Mexico,Albuquerque,10140 Lomas NE,1,6,7,201503,2015
311922,23-03-2015,Tennessee,Clarksville,900 block of Carpenter Street,1,4,5,201503,2015
314044,27-03-2015,Florida,Panama City Beach,5312 Thomas Drive,0,7,7,201503,2015
306897,2014-03-2015,Georgia,Atlanta,2900 block of Delmar Lane,0,5,5,201503,2015
305907,13-03-2015,Mississippi,Brookhaven,1097 South First St.,2,3,5,201503,2015
304238,10-03-2015,Georgia,Columbus,3023 Victory Drive,0,5,5,201503,2015
300860,4-03-2015,California,San Bernardino,190 block of W Club Center Dr,3,4,7,201503,2015
308687,2017-03-2015,California,Stockton,748 N Madison St,3,4,7,201503,2015
308728,2018-03-2015,Arizona,Mesa,1504 West Main Street,1,5,6,201503,2015
468151,20-03-2015,Texas,Lancaster,1500 block of Reynolds Street,1,5,6,201503,2015
330611,27-04-2015,New York,Brooklyn,1365 Flatbush Ave,2,4,6,201504,2015
327341,2018-04-2015,Alabama,Montgomery,1800 block of Gibbs Court,0,5,5,201504,2015
326792,21-04-2015,Texas,Killeen,420 Gilmer St,2,3,5,201504,2015
325445,2018-04-2015,Pennsylvania,Williamsport,321 Pine St,0,5,5,201504,2015
329322,25-04-2015,New York,Gates,24 Hinchey Rd,1,6,7,201504,2015
318297,5-04-2015,Indiana,Indianapolis,5000 block of Wildflower Court,0,5,5,201504,2015
318221,5-04-2015,Kentucky,Louisville,40th and Grand Street,1,4,5,201504,2015
316795,2-04-2015,Maryland,Baltimore,1900 block of West Lanvale Street,0,5,5,201504,2015
324424,2016-04-2015,Arizona,Phoenix,4300 block of East Anderson Drive,5,0,5,201504,2015
342589,2018-05-2015,Florida,Miami,Northwest 75th Street and Northwest 16th Avenue,1,4,5,201505,2015
350182,31-05-2015,Georgia,Conyers,4669 Bell Road SE,3,2,5,201505,2015
349976,31-05-2015,Connecticut,New Haven,849 Chapel Street,0,5,5,201505,2015
348620,28-05-2015,Illinois,Chicago,6200 block of South Honore Street,0,5,5,201505,2015
346097,25-05-2015,Illinois,Decatur,1816 N Water,1,4,5,201505,2015
345749,24-05-2015,Michigan,Flint,W. 12th Street and Hammerberg Road.,0,7,7,201505,2015
345681,24-05-2015,Massachusetts,Brockton,1002 Main St,0,5,5,201505,2015
341622,2017-05-2015,Texas,Waco,4671 S Jack Kultgen Fwy,9,18,27,201505,2015
340280,12-05-2015,Maryland,Capitol Heights,4700 block of Pard Rd,1,4,5,201505,2015
341232,2016-05-2015,Maryland,Baltimore,1700 block of North Broadway,0,5,5,201505,2015
339229,12-05-2015,Arizona,Tucson,800 block of West Calle Medina Road,5,0,5,201505,2015
337855,10-05-2015,Ohio,Cleveland,3600 block of Bosworth Rd,1,4,5,201505,2015
333750,3-05-2015,Wisconsin,Menasha,Friendship Trail,4,1,5,201505,2015
333584,3-05-2015,Texas,Houston,San Jacinto at Elgin,0,6,6,201505,2015
333576,3-05-2015,Ohio,Dayton,2801 Germantown Street,1,6,7,201505,2015
332732,1-05-2015,Wisconsin,Milwaukee,3700 block of 37th Street,2,3,5,201505,2015
341465,2016-05-2015,Wisconsin,Milwaukee,28th Street and Auer Avenue,0,5,5,201505,2015
361198,20-06-2015,Pennsylvania,Philadelphia,4100 block of Ogden Street,0,11,11,201506,2015
367099,28-06-2015,Illinois,Venice,1430 Broadway,0,6,6,201506,2015
365399,28-06-2015,Delaware,Harrington,100 block of East St,0,6,6,201506,2015
365391,28-06-2015,Michigan,Detroit,Gratiot and Loretto,0,5,5,201506,2015
361948,22-06-2015,Pennsylvania,Philadelphia,700 block of East Hilton Street,0,7,7,201506,2015
361708,21-06-2015,Kentucky,Lexington,726 Georgetown St,1,4,5,201506,2015
361212,20-06-2015,Michigan,Detroit,Dexter and Webb,1,11,12,201506,2015
359830,2017-06-2015,South Carolina,Charleston,110 Calhoun Street,9,0,9,201506,2015
353037,6-06-2015,Illinois,Chicago,100 block of North Lorel Avenue,0,5,5,201506,2015
357701,13-06-2015,New York,Bronx,2409 Creston Avenue,0,5,5,201506,2015
357164,13-06-2015,Ohio,Columbus,1623 E. Hudson Street,4,1,5,201506,2015
356065,11-06-2015,Connecticut,Bridgeport,468 Trumbull Ave,1,8,9,201506,2015
353854,7-06-2015,Montana,Deer Lodge,Boulder Creek Road,5,0,5,201506,2015
353536,6-06-2015,New York,Buffalo,100 block of Warren Avenue,1,4,5,201506,2015
353382,5-06-2015,Iowa,Davenport,900 block of West 3rd St,0,5,5,201506,2015
357732,13-06-2015,Georgia,Fayetteville,600 block of Highway 279,1,4,5,201506,2015
376211,2017-07-2015,Illinois,Chicago,4400 block of W. Maypole,0,5,5,201507,2015
375773,2016-07-2015,Texas,Dallas,Singleton and Hampton,0,5,5,201507,2015
375412,2015-07-2015,Ohio,Cleveland,700 block of Thornhill,0,7,7,201507,2015
375022,2016-07-2015,Tennessee,Chattanooga,4051 Amnicola Highway,6,2,8,201507,2015
374630,2015-07-2015,South Carolina,Holly Hill,7050 Old State Road,4,1,5,201507,2015
369014,5-07-2015,Louisiana,Shreveport,3500 block of Hearne Avenue,0,8,8,201507,2015
373768,13-07-2015,California,Stockton,400 block of McCloud Avenue,1,4,5,201507,2015
373095,12-07-2015,Illinois,River Forest,116 Lathrop Avenue,2,3,5,201507,2015
368987,4-07-2015,Massachusetts,Pittsfield,Dewey Avenue,1,4,5,201507,2015
368732,5-07-2015,Indiana,Fort Wayne,1400 block of McCulloch Street,0,9,9,201507,2015
376702,2018-07-2015,Oregon,Salem,1550 Weston Ct NE,1,4,5,201507,2015
374602,2015-07-2015,Georgia,Atlanta,500 block of Center Hill Avenue,0,5,5,201507,2015
377047,2019-07-2015,Kentucky,Louisville,2928 W Kentucky St,0,6,6,201507,2015
377878,20-07-2015,New York,Bronx,E. 153rd St. and the Grand Concourse,0,6,6,201507,2015
379166,22-07-2015,Georgia,Suwanee,5500 block of Old Atlanta Road,5,0,5,201507,2015
382459,27-07-2015,Illinois,Rockford,900 block of Kent Street,0,5,5,201507,2015
382413,24-07-2015,Pennsylvania,Erie,200 block of W 29th St,2,5,7,201507,2015
390936,2018-07-2015,California,Santa Paula,Ojai-Santa Paula Street,0,5,5,201507,2015
381814,26-07-2015,Missouri,Kansas City,Thompson and Colorado,2,3,5,201507,2015
380162,23-07-2015,Louisiana,Lafayette,3141 Johnson Street,3,9,12,201507,2015
382230,22-07-2015,Missouri,Saint Louis,Fair Ave and Ashland Ave,0,6,6,201507,2015
404238,29-08-2015,Tennessee,Bristol,618 Henson Road,3,2,5,201508,2015
404167,30-08-2015,Tennessee,Memphis,3300 block of Sobota Circle,1,4,5,201508,2015
400091,23-08-2015,California,Modesto,1100 block of Kansas Avenue,1,7,8,201508,2015
399367,21-08-2015,Ohio,Cincinnati,Mathis and Prentice,2,5,7,201508,2015
399212,21-08-2015,North Carolina,Durham,2700 block of Hinson Drive,0,8,8,201508,2015
398361,2019-08-2015,New York,Rochester,500 Genesee St,3,4,7,201508,2015
395718,2016-08-2015,South Carolina,Bennettsville,Highway 38N,0,5,5,201508,2015
395844,2016-08-2015,Texas,Fort Worth,3651 Sycamore School Rd,0,6,6,201508,2015
390774,8-08-2015,Arkansas,Blytheville,833 Anderson Street,1,11,12,201508,2015
390526,8-08-2015,Texas,Houston,2211 Falling Oaks,8,0,8,201508,2015
389149,4-08-2015,Missouri,Saint Louis,2500 block of Semple,1,4,5,201508,2015
387194,3-08-2015,New York,Brooklyn,98 Dwight Street,0,5,5,201508,2015
386140,2-08-2015,Maryland,Baltimore,2700 block of Garrison Avenue,0,7,7,201508,2015
386066,2-08-2015,Georgia,Savannah,Barnard Street,0,5,5,201508,2015
385824,2-08-2015,Illinois,Chicago,4800 block of West Kamerling Avenue,1,4,5,201508,2015
385779,2-08-2015,New York,Brooklyn,Stanley Avenue and Crescent Street,0,9,9,201508,2015
390914,8-08-2015,North Carolina,Gastonia,4908 Greenwood Drive,2,3,5,201508,2015
419250,23-09-2015,Louisiana,Shreveport,2900 block of Peach Street,0,5,5,201509,2015
422064,28-09-2015,Illinois,Chicago,300 block of West 42nd Street,3,2,5,201509,2015
422035,28-09-2015,Illinois,Chicago,5300 block of South Aberdeen Street,2,3,5,201509,2015
421650,28-09-2015,Ohio,Cincinnati (Evanston),1800 block of Hewitt Avenue,0,5,5,201509,2015
421014,27-09-2015,Georgia,Greenville,1140 Hill Haven Road,0,10,10,201509,2015
419718,24-09-2015,Illinois,Chicago,5100 block of South Morgan Street,0,5,5,201509,2015
418318,2017-09-2015,South Dakota,Geddes,36705 379th Street,6,0,6,201509,2015
413001,13-09-2015,Florida,Ocala,1910 South Pine Avenue,1,5,6,201509,2015
416872,20-09-2015,Illinois,Chicago,5700 block of South LaSalle,1,5,6,201509,2015
412557,11-09-2015,North Carolina,Charlotte,1000 North Carolina Music Factory Blvd.,0,5,5,201509,2015
412529,12-09-2015,Minnesota,Minneapolis,1st Ave. and N. 5th St.,0,6,6,201509,2015
412487,12-09-2015,New York,Rochester,36 Woodward Street,2,4,6,201509,2015
412040,10-09-2015,Minnesota,Excelsior (Greenwood),Channel Drive,5,0,5,201509,2015
409732,7-09-2015,Indiana,Gary,9300 block of Sunrise,2,4,6,201509,2015
417013,20-09-2015,Oklahoma,Tulsa,Pine and Yale,0,6,6,201509,2015
437836,27-10-2015,Texas,Fort Worth,1700 block of Southcrest Drive,0,5,5,201510,2015
437323,26-10-2015,Indiana,Evansville,711 E Virginia St,0,5,5,201510,2015
436240,25-10-2015,District of Columbia,Washington,4300 block of Wheeler Road SE,0,5,5,201510,2015
436234,25-10-2015,Arizona,Phoenix,Seventh Street and Broadway,1,4,5,201510,2015
433146,2019-10-2015,Illinois,Calumet City,300 Campbell Avenue,0,6,6,201510,2015
436202,25-10-2015,North Carolina,Four Oaks,2339 Stricklands Crossroads Road,0,5,5,201510,2015
428215,10-10-2015,Tennessee,Memphis,6135 Mount Moriah Road,0,6,6,201510,2015
426256,6-10-2015,Maryland,Baltimore,300 block of North Payson Street,0,5,5,201510,2015
424224,2-10-2015,Maryland,Baltimore,5400 Reisterstown Road,1,4,5,201510,2015
423223,1-10-2015,Oregon,Roseburg,1140 Umpqua College Rd,10,9,19,201510,2015
432466,2017-10-2015,Florida,Fort Myers,2224 First St,1,4,5,201510,2015
452120,23-11-2015,Minnesota,Minneapolis,Morgan Avenue North,0,5,5,201511,2015
441681,3-11-2015,Florida,Jacksonville,Ella Street and Kings Road,2,3,5,201511,2015
446996,13-11-2015,Florida,Jacksonville,1300 block of South Shirley Oaks Drive,4,1,5,201511,2015
448419,2015-11-2015,Texas,Tennessee Colony,800 block of An County Rd 2217,5,0,5,201511,2015
452007,23-11-2015,Ohio,Columbus,90 block of S. Terrace Avenue,4,1,5,201511,2015
451495,22-11-2015,Louisiana,New Orleans,1900 block of Gallier St,0,17,17,201511,2015
454059,27-11-2015,Colorado,Colorado Springs,3480 Centennial Blvd,3,9,12,201511,2015
455394,29-11-2015,Illinois,Kankakee,648 E Court St,0,5,5,201511,2015
451305,22-11-2015,New York,Newburgh,203 Broadway,0,5,5,201511,2015
449814,2018-11-2015,California,Fresno,California Avenue and Martin Luther King Jr. Boulevard,0,5,5,201511,2015
476321,31-12-2015,Louisiana,New Orleans,1900 block of Amelia Street,0,6,6,201512,2015
468968,20-12-2015,North Carolina,Wilmington,11th and Castle Street,1,4,5,201512,2015
468787,20-12-2015,Florida,Miami (Goulds),21630 Southwest 120th Avenue,1,4,5,201512,2015
460386,6-12-2015,Nebraska,Omaha,North 108th Street and Military Road,2,3,5,201512,2015
456893,2-12-2015,California,San Bernardino,1365 South Waterman Avenue,16,19,35,201512,2015
50379,8-01-2016,Illinois,Chicago,1500 block of South Kedzie,1,4,5,201601,2016
50377,11-01-2016,Delaware,Wilmington,900 block of Brown Street,1,4,5,201601,2016
50371,30-01-2016,Arizona,Glendale,67th and Missouri Avenue,3,5,8,201601,2016
50372,27-01-2016,Virginia,Chesapeake,1401 N. George Washington Hwy,6,0,6,201601,2016
50373,26-01-2016,Washington,Seattle,Airport Way S. and S. Atlantic St.,2,3,5,201601,2016
50374,25-01-2016,California,Perris,140 S. D Street,1,4,5,201601,2016
50365,7-02-2016,New York,Rochester,547 State St,1,7,8,201602,2016
50344,28-02-2016,Michigan,Detroit,8800 block of Livernois,0,5,5,201602,2016
50347,26-02-2016,Washington,Belfair,300 block of Horseshoe Rd.,5,0,5,201602,2016
50348,25-02-2016,Kansas,Hesston,200 S Ridge Rd,4,14,18,201602,2016
50369,6-02-2016,Florida,Tampa,8123 N Nebraska Ave,2,6,8,201602,2016
50351,21-02-2016,Texas,Houston,5100 block of Idaho Street,0,5,5,201602,2016
50357,20-02-2016,Mississippi,Iuka,231 Co Rd 201,2,3,5,201602,2016
50361,2014-02-2016,Alabama,Eutaw (Union),Earnest Friday Road,0,5,5,201602,2016
50363,7-02-2016,Mississippi,Pass Christian,Davis Avenue,2,4,6,201602,2016
50364,7-02-2016,Florida,Orlando,7432 Universal Blvd,2,10,12,201602,2016
50349,23-02-2016,Arizona,Glendale,4812 West Sunnyside Ave,5,0,5,201602,2016
50354,20-02-2016,Michigan,Kalamazoo,5581 Cracker Barrel Blvd,6,2,8,201602,2016
50335,9-03-2016,Pennsylvania,Pittsburgh,1304 Franklin Ave,5,3,8,201603,2016
50334,11-03-2016,New Jersey,Trenton,Oliver Avenue,0,5,5,201603,2016
50329,2015-03-2016,Georgia,Atlanta,Donald Lee Hollowell Drive,0,5,5,201603,2016
50327,2019-03-2016,Florida,Plantation,12050 NW 4th Court,1,4,5,201603,2016
50341,6-03-2016,California,Compton,900 block of West Victoria Street,1,8,9,201603,2016
50339,6-03-2016,Massachusetts,Chelsea,120 Washington Avenue,1,6,7,201603,2016
50338,7-03-2016,Kansas,Kansas City,3000 block of South 36th Street,5,0,5,201603,2016
50336,8-03-2016,Texas,San Antonio,Sherman St,2,3,5,201603,2016
50291,29-04-2016,California,Oakland,3200 block of San Pablo Avenue,0,5,5,201604,2016
50294,26-04-2016,Maryland,District Heights (Forestville),6500 block of Hil-Mar Drive,1,4,5,201604,2016
50296,25-04-2016,Florida,Miami,1506 Northwest 70th Street,0,5,5,201604,2016
50297,24-04-2016,Virginia,Halifax,1055 L P Bailey Memorial Hwy,0,5,5,201604,2016
50298,24-04-2016,Illinois,Chicago (Englewood),2000 block of West 68th Place,2,3,5,201604,2016
50304,22-04-2016,Ohio,Piketon,4077 Union Hill Rd,8,0,8,201604,2016
50307,2019-04-2016,Alabama,Blountsville,81551 US Highway 278,1,4,5,201604,2016
50309,2019-04-2016,Illinois,Chicago,1400 block of West 84th Street,1,4,5,201604,2016
50313,2017-04-2016,Texas,Edinburg,5021 W St Hwy 107,1,6,7,201604,2016
50314,2016-04-2016,Michigan,Detroit,9500 block of Oakland,1,4,5,201604,2016
50315,2016-04-2016,Florida,Orlando,1100 block of Conley Street,2,4,6,201604,2016
50303,23-04-2016,Kansas,Topeka,3732 SW Topeka Blvd,1,4,5,201604,2016
50305,22-04-2016,Georgia,Appling,3162 Johnson Drive,6,0,6,201604,2016
50268,29-05-2016,Texas,Houston,13210 Memorial Dr,2,6,8,201605,2016
50263,30-05-2016,Maryland,Baltimore,500 block of East 43rd Street,0,5,5,201605,2016
50264,30-05-2016,California,Sacramento,3900 block of 44th,0,5,5,201605,2016
50266,29-05-2016,New Jersey,Trenton,600 block of Martin Luther King Jr. Boulevard,0,6,6,201605,2016
50269,23-05-2016,New Jersey,Newark,102 Isabella Avenue,0,5,5,201605,2016
50278,2014-05-2016,Georgia,Atlanta,Cordova and Peoples Street,0,5,5,201605,2016
50289,1-05-2016,Tennessee,Murfreesboro,1955 Old Castle Drive,0,5,5,201605,2016
50288,4-05-2016,Minnesota,Minneapolis,16th Avenue North and Newton Avenue North,1,7,8,201605,2016
50286,5-05-2016,Louisiana,Shreveport,300 block of North Thomas Drive,2,6,8,201605,2016
50285,6-05-2016,Maryland,Bethesda,7101 Democracy Blvd,3,3,6,201605,2016
50276,2015-05-2016,Georgia,Moultrie,Rossman Dairy Road,5,0,5,201605,2016
50281,11-05-2016,Illinois,Chicago,7100 block of South State Street,0,5,5,201605,2016
50280,11-05-2016,Alabama,Birmingham,1400 block of 21st St N,1,4,5,201605,2016
50283,6-05-2016,Michigan,Detroit,12300 block of Gratiot,1,4,5,201605,2016
50247,11-06-2016,New Mexico,Roswell,2300 block of Davis Ave,5,0,5,201606,2016
50251,11-06-2016,California,Panorama City,8500 block of Cedros Avenue,3,2,5,201606,2016
50216,30-06-2016,Illinois,Chicago,9500 block of South Loomis Street,1,4,5,201606,2016
50217,29-06-2016,Nevada,Las Vegas,6100 block of West Lake Mead Boulevard,5,0,5,201606,2016
50257,5-06-2016,Florida,Cape Coral,2600 block of Skyline Boulevard S,3,3,6,201606,2016
50223,26-06-2016,Georgia,Atlanta,1500 block of Moreland Avenue SE,1,4,5,201606,2016
50258,5-06-2016,Arizona,Phoenix,8152 N Black Canyon Hwy,2,4,6,201606,2016
50230,24-06-2016,Connecticut,Hartford,Brook and Winter Street,0,5,5,201606,2016
50246,12-06-2016,Florida,Orlando,1912 S Orange Ave,50,53,103,201606,2016
50226,25-06-2016,Texas,Fort Worth,2466 East Lancaster Avenue,2,5,7,201606,2016
50245,13-06-2016,Illinois,Chicago,3200 block of West Congress,0,5,5,201606,2016
50222,26-06-2016,North Carolina,Charlotte,2240 Camp Greene St,0,5,5,201606,2016
50233,22-06-2016,Georgia,Dekalb (county),Lancashire Drive and Central Drive,1,4,5,201606,2016
50231,24-06-2016,Maryland,District Heights,3100 block of Orleans Ave,3,2,5,201606,2016
50244,13-06-2016,New York,Brooklyn,Avenue D and E. 57th,0,5,5,201606,2016
50182,22-07-2016,Illinois,Kankakee,300 block of North Wildwood Avenue,0,5,5,201607,2016
50168,31-07-2016,Texas,Austin,208 E 6th St,1,4,5,201607,2016
50169,30-07-2016,Missouri,Saint Louis,5000 block of Kensington Ave,0,5,5,201607,2016
50172,29-07-2016,Georgia,Athens,Trail Creek St,0,7,7,201607,2016
50173,28-07-2016,New York,Elmira,303 College Ave,0,5,5,201607,2016
50176,25-07-2016,Florida,Fort Myers,3580 Evans Ave,2,19,21,201607,2016
50177,24-07-2016,Ohio,Hamilton,1555 Main St,1,7,8,201607,2016
50181,23-07-2016,Texas,Bastrop,202 Childers Drive,4,1,5,201607,2016
50171,30-07-2016,Georgia,Townsend (Eulonia),14699 Highway 17,0,5,5,201607,2016
50188,2017-07-2016,Louisiana,Baton Rouge,9611 Airline Hwy,4,3,7,201607,2016
50189,2016-07-2016,Texas,Dallas,6300 block of Benavides Drive,0,5,5,201607,2016
50214,3-07-2016,Louisiana,Monroe,401 Lea Joyner Memorial Expy,2,3,5,201607,2016
50213,4-07-2016,Arizona,Phoenix,4000 block of West Southern Avenue,2,6,8,201607,2016
50209,4-07-2016,Texas,Houston,1312 Robin,3,2,5,201607,2016
50183,21-07-2016,Illinois,Chicago,4400 block of South Leamington,0,5,5,201607,2016
50208,4-07-2016,New York,Brooklyn,419 Chauncey St,0,7,7,201607,2016
50206,7-07-2016,Tennessee,Bristol,536 Volunteer Pkwy,1,4,5,201607,2016
50191,2016-07-2016,California,Bakersfield,621 Stephens Dr,1,14,15,201607,2016
50203,11-07-2016,Michigan,Saint Joseph,811 Port St,3,2,5,201607,2016
50200,11-07-2016,Maryland,Baltimore,1800 block of W. North Avenue,0,5,5,201607,2016
50190,2016-07-2016,Ohio,Cleveland,5000 block of Euclid Avenue,0,5,5,201607,2016
50193,2016-07-2016,Tennessee,Clarksville,1348 College Street,0,6,6,201607,2016
50198,13-07-2016,Georgia,Warner Robins,105 Magnolia Avenue,0,5,5,201607,2016
50205,7-07-2016,Texas,Dallas,800 Main St,5,9,14,201607,2016
50128,29-08-2016,New Jersey,Egg Harbor City,907 White Horse Pike,1,5,6,201608,2016
50132,28-08-2016,Alabama,Dadeville,512 E Columbus St,0,5,5,201608,2016
50133,27-08-2016,Alabama,Bessemer (Brighton),3810 7th Ave,1,6,7,201608,2016
50129,28-08-2016,Texas,Lubbock,2200 block of 17th St,0,6,6,201608,2016
50135,25-08-2016,New Jersey,Bridgeton,Marion Street,0,5,5,201608,2016
50137,21-08-2016,Connecticut,Bridgeport,19 Plymouth St,0,13,13,201608,2016
50139,20-08-2016,Washington,Tacoma,900 block of Pacific Avenue,0,5,5,201608,2016
50140,20-08-2016,Alabama,Citronelle,Jim Platt Road,5,0,5,201608,2016
50144,2014-08-2016,Minnesota,Minneapolis,1717 Plymouth Ave N,0,5,5,201608,2016
50154,8-08-2016,Florida,Jacksonville,1214 Labelle St,0,7,7,201608,2016
50160,6-08-2016,Pennsylvania,Reading (Sinking Spring),51 Winding Brook Drive,5,0,5,201608,2016
50134,27-08-2016,Florida,Miami,1900 block of NW 83rd Terr,2,4,6,201608,2016
50104,2017-09-2016,Florida,Miami,20582 SW 119th Ave,0,6,6,201609,2016
50097,26-09-2016,Texas,Houston,5450 Weslayan St,1,6,7,201609,2016
50099,24-09-2016,Maryland,Baltimore,Greenmount Ave and Preston St,0,8,8,201609,2016
50100,23-09-2016,Washington,Burlington,201 Cascade Mall Dr,5,0,5,201609,2016
50105,2017-09-2016,Florida,Orlando,3918 Columbia St,1,6,7,201609,2016
50113,11-09-2016,Missouri,Kansas City,500 block of Westport Rd,0,6,6,201609,2016
50109,2016-09-2016,Pennsylvania,Philadelphia,5100 block of Sansom St,2,5,7,201609,2016
50111,13-09-2016,Indiana,Fort Wayne,1723 E Wayne St,3,2,5,201609,2016
50112,11-09-2016,Louisiana,New Orleans,2349 S Claiborne Ave,1,5,6,201609,2016
50114,11-09-2016,Michigan,Saginaw,2207 Pierce Road,0,5,5,201609,2016
50115,11-09-2016,North Carolina,New Bern,1100 block of Highway 70,0,5,5,201609,2016
50120,8-09-2016,Arkansas,Hot Springs National Park (Hot Springs),300 block of Lacey St,1,4,5,201609,2016
50121,5-09-2016,Illinois,Chicago,2700 block of W Lexington Ave,2,3,5,201609,2016
50123,4-09-2016,Virginia,Roanoke,1020 Orange Ave NE,1,10,11,201609,2016
50107,2017-09-2016,District of Columbia,Washington,2600 block of Birney Place SE,2,7,9,201609,2016
50070,29-10-2016,California,Los Angeles,1600 block of Century Boulevard,0,5,5,201610,2016
50065,30-10-2016,Maryland,Capitol Heights,6862 Walker Mill Rd,3,3,6,201610,2016
50067,30-10-2016,New York,Newburgh,119 First Street,2,5,7,201610,2016
50068,30-10-2016,Texas,San Antonio,2900 block of Aspen Meadow,0,5,5,201610,2016
50072,28-10-2016,Mississippi,Jackson,200 block of Lorenz Blvd,0,6,6,201610,2016
50083,2015-10-2016,California,Los Angeles,2918 Rimpau Blvd,4,11,15,201610,2016
50077,23-10-2016,Oklahoma,Wellston,Highway 66 and N 3310 Rd,1,5,6,201610,2016
50089,4-10-2016,Louisiana,New Orleans,3727 Ulloa Street,3,2,5,201610,2016
50086,9-10-2016,Michigan,Grand Rapids,1850 28th Street SE,1,8,9,201610,2016
50084,2014-10-2016,Illinois,Chicago,3300 block of W Maypole Ave,1,6,7,201610,2016
50076,25-10-2016,Virginia,Roanoke,830 Campbell Avenue Southeast,2,3,5,201610,2016
50091,2-10-2016,Texas,San Antonio,2600 South Flores Street,1,4,5,201610,2016
50078,22-10-2016,California,Oakland,77th and Bancroft Avenues,0,7,7,201610,2016
50080,2017-10-2016,Illinois,Chicago (Englewood),6700 block of South Winchester,1,4,5,201610,2016
50081,2015-10-2016,Alabama,Mobile,1800 block of St Stephens Road,0,5,5,201610,2016
50082,2015-10-2016,Illinois,Rockford,7801 East State St,1,5,6,201610,2016
50061,2-11-2016,Arkansas,Little Rock,2111 Bragg Street,1,4,5,201611,2016
50027,30-11-2016,Maryland,Baltimore,2901 Garrison Blvd,2,4,6,201611,2016
50031,27-11-2016,Louisiana,New Orleans,100 block of Bourbon Street,1,9,10,201611,2016
50032,27-11-2016,Missouri,Kansas City,Gregory and Prospect,0,7,7,201611,2016
50033,26-11-2016,Illinois,Chicago,8800 block of S Exchange Ave,1,5,6,201611,2016
50035,24-11-2016,Kentucky,Louisville,4501 W Broadway,2,4,6,201611,2016
50038,22-11-2016,Florida,Clewiston,1068 Harlem Academy Ave,1,4,5,201611,2016
50040,2017-11-2016,Tennessee,Dyersburg,160 Longfellow,1,7,8,201611,2016
50041,13-11-2016,Florida,Jacksonville,5105 Cleveland Rd,3,2,5,201611,2016
50045,12-11-2016,California,Sacramento,8600 block of Ardith Drive,1,5,6,201611,2016
50047,12-11-2016,Connecticut,Bridgeport,2500 Park Avenue,0,5,5,201611,2016
50050,9-11-2016,Washington,Seattle,1524 3rd Ave,0,5,5,201611,2016
50055,5-11-2016,South Carolina,Myrtle Beach,803 Main St,0,5,5,201611,2016
50056,5-11-2016,California,Oakland,420 14th Street,0,8,8,201611,2016
50057,5-11-2016,Illinois,Chicago,4800 block of North Winthrop,0,5,5,201611,2016
50062,1-11-2016,Tennessee,Memphis,5200 block of Zodiac Rd,1,5,6,201611,2016
50043,13-11-2016,California,San Diego,3800 block of Marlborough Avenue,3,2,5,201611,2016
50002,30-12-2016,Ohio,Mansfield,3230 Possum Run Rd,0,5,5,201612,2016
50004,28-12-2016,Georgia,Columbus,2914 10th Street,1,4,5,201612,2016
50005,25-12-2016,Illinois,Chicago,8600 block of S Maryland Ave,3,4,7,201612,2016
50003,30-12-2016,Connecticut,Wallingford,95 S Turnpike Rd,2,3,5,201612,2016
50007,25-12-2016,New York,Mount Vernon,4 North 3rd Avenue,1,5,6,201612,2016
50008,24-12-2016,North Carolina,Madison,490 K Ford Rd,0,7,7,201612,2016
50012,2017-12-2016,Illinois,Chicago (Roseland),100 block of W 105th St,5,0,5,201612,2016
50018,11-12-2016,Florida,Orlando (Pine Hills),4305 N Pine Hills Rd,1,4,5,201612,2016
50019,11-12-2016,Maryland,Baltimore,3916 South Hanover Street,0,5,5,201612,2016
50023,5-12-2016,New Mexico,Albuquerque,1532 Stagecoach Lane,4,1,5,201612,2016
50024,3-12-2016,California,Los Angeles,91st Street and Western Avenue,0,6,6,201612,2016
50025,2-12-2016,New Jersey,Bloomfield,3 1st Ave,0,6,6,201612,2016
60328,20-01-2017,Mississippi,Como,Smart Road,1,4,5,201701,2017
60317,29-01-2017,Louisiana,Shreveport,6363 Hearne Ave,1,4,5,201701,2017
60319,27-01-2017,Tennessee,Brownsville,221 Morgan St,0,10,10,201701,2017
60320,26-01-2017,Georgia,Albany,1510 Maryland Drive,2,3,5,201701,2017
60321,25-01-2017,Illinois,Chicago,500 block of E 75th St,0,6,6,201701,2017
60322,22-01-2017,Texas,Manvel,200 block of Oak Shore Dr,3,2,5,201701,2017
60325,21-01-2017,Georgia,Jonesboro,6510 Tara Blvd,0,6,6,201701,2017
60331,2016-01-2017,Florida,Miami,6011 NW 32nd Ave,0,8,8,201701,2017
60333,2015-01-2017,Mississippi,Magnolia,6000 block of Church Road,1,4,5,201701,2017
60334,12-01-2017,Missouri,Kansas City,8607 E 61st Terrace,3,2,5,201701,2017
60340,6-01-2017,Florida,Fort Lauderdale,100 Terminal Dr,5,6,11,201701,2017
60343,1-01-2017,Mississippi,Winstonville,114 North Greyer Street,0,5,5,201701,2017
60345,1-01-2017,Florida,Miami,8000 block of NW 14th Ave,0,7,7,201701,2017
60326,21-01-2017,Florida,Boynton Beach,500 NE 2nd St,0,5,5,201701,2017
60297,20-02-2017,Ohio,Cleveland,1082 East 105th Street,0,5,5,201702,2017
60291,26-02-2017,Indiana,Gary,1700 Grant St,1,4,5,201702,2017
60292,25-02-2017,Ohio,Warren,1564 Niles Cortland Rd SE,2,3,5,201702,2017
60293,25-02-2017,Florida,Jacksonville,3604 Moncrief Rd,1,4,5,201702,2017
60302,2015-02-2017,Illinois,Chicago,3949 South Albany Avenue,3,2,5,201702,2017
60303,12-02-2017,Missouri,Caruthersville,908 Truman Blvd,1,6,7,201702,2017
60305,12-02-2017,Florida,Greenville,Church Ave and Obadiah St,0,5,5,201702,2017
60308,10-02-2017,Louisiana,New Orleans,2nd St and Dryades St,1,5,6,201702,2017
60310,8-02-2017,Ohio,Cleveland,16379 Euclid Ave,1,4,5,201702,2017
60312,7-02-2017,Arkansas,Little Rock,25 Par Drive,1,4,5,201702,2017
60289,28-02-2017,Ohio,Cincinnati,1700 of Casey Dr,0,6,6,201702,2017
60268,27-03-2017,Florida,Sanford,209 Hays Dr,2,4,6,201703,2017
60271,26-03-2017,Ohio,Cincinnati,4601 Kellogg Ave,2,15,17,201703,2017
60270,26-03-2017,Texas,Houston,5619 Aldine Bender Rd,2,4,6,201703,2017
60272,25-03-2017,Tennessee,Knoxville,Minnesota Ave,1,4,5,201703,2017
60279,2018-03-2017,Michigan,Detroit,16000 block of Rutherford,3,2,5,201703,2017
60276,24-03-2017,Missouri,Saint Louis,5100 block of Palm St,1,6,7,201703,2017
60277,22-03-2017,Wisconsin,Rothschild,1133 E Grand Ave,5,0,5,201703,2017
60278,2019-03-2017,Kentucky,Louisville,1512 Portland Avenue,1,5,6,201703,2017
60285,4-03-2017,Kansas,Topeka,23rd and Bellview,1,4,5,201703,2017
60288,3-03-2017,California,Riverside,8300 block of Trey Ave,0,5,5,201703,2017
60275,24-03-2017,California,Fresno,300 block of South Villa Avenue,1,4,5,201703,2017
60234,29-04-2017,California,Whittier,10000 block of Carmentia Rd,1,5,6,201704,2017
60228,30-04-2017,California,San Diego,9080 Judicial Dr,2,6,8,201704,2017
60229,30-04-2017,Kansas,Topeka,4104 SW 28th,4,1,5,201704,2017
60230,30-04-2017,Florida,Jacksonville,1200 Ken Knight Dr N,0,5,5,201704,2017
60231,30-04-2017,South Carolina,Loris,268 N Sea Green Rd,1,5,6,201704,2017
60233,29-04-2017,California,Sacramento,3800 block of 26th Avenue,0,5,5,201704,2017
60245,2016-04-2017,Ohio,Columbus,1710 Cleveland Av,0,9,9,201704,2017
60265,1-04-2017,Florida,Tampa,219 S Howard Ave,1,4,5,201704,2017
60256,7-04-2017,Texas,Houston,3829 Mount Pleasant St,5,0,5,201704,2017
60257,7-04-2017,Minnesota,Saint Paul,1600 block of English St,4,1,5,201704,2017
60258,7-04-2017,Illinois,Chicago,5600 block of W Lake St,1,5,6,201704,2017
60261,3-04-2017,Texas,Lubbock,5401 Ave Q,0,7,7,201704,2017
60262,2-04-2017,Illinois,Chicago,3500 block of W Van Buren St,2,4,6,201704,2017
60263,2-04-2017,Iowa,Des Moines,2500 Martin Luther King Jr. Parkway,0,5,5,201704,2017
60264,1-04-2017,California,Pittsburg,100 block of Madoline Street,0,5,5,201704,2017
60266,1-04-2017,Oklahoma,Oklahoma City,1200 block of N Woodward Avenue,2,3,5,201704,2017
60249,2015-04-2017,Alabama,Birmingham,1480 Center Point Pkwy,0,6,6,201704,2017
60207,28-05-2017,Alabama,Phenix City,100 block of 6th Street South,0,12,12,201705,2017
60208,28-05-2017,New Jersey,Paterson,86 Main Street,1,5,6,201705,2017
60209,28-05-2017,Mississippi,Moss Point,6103 Hwy. 63,0,5,5,201705,2017
60211,27-05-2017,District of Columbia,Washington,100 block of Q St NW,1,7,8,201705,2017
60212,27-05-2017,Mississippi,Bogue Chitto,2871 Lee Dr,8,1,9,201705,2017
60216,20-05-2017,Pennsylvania,Philadelphia,2100 block of W Huntingdon St,0,10,10,201705,2017
60218,2014-05-2017,Arkansas,Jonesboro,311 S Main St,1,6,7,201705,2017
60219,2014-05-2017,Illinois,Dolton,14112 Chicago Road,0,5,5,201705,2017
60220,2014-05-2017,Florida,Avon Park,Hal McRae Blvd and Delaney Ave,0,5,5,201705,2017
60224,7-05-2017,Illinois,Chicago,2600 block of 46th Pl,2,8,10,201705,2017
60227,1-05-2017,Texas,Dallas,3200 block of Reynolds Ave,2,3,5,201705,2017
60174,24-06-2017,Florida,Fort Lauderdale,2335 NW 16th Ct,1,4,5,201706,2017
60175,24-06-2017,New York,New York (Manhattan),114th St and Manhattan Ave,0,5,5,201706,2017
60177,22-06-2017,Georgia,Atlanta,1100 block of Osborne Street,1,6,7,201706,2017
60178,2018-06-2017,Missouri,Saint Louis,1900 block of N 14th St,3,2,5,201706,2017
60181,2018-06-2017,South Carolina,Myrtle Beach,311 N Ocean Blvd,0,7,7,201706,2017
60171,27-06-2017,Illinois,Chicago,200 block of S Lotus,0,5,5,201706,2017
60183,2017-06-2017,Ohio,Columbus,6252 Busch Blvd,1,4,5,201706,2017
60203,2-06-2017,Texas,Laredo,5301 McPherson Rd,2,3,5,201706,2017
60186,2014-06-2017,Virginia,Alexandria,420 E Monroe Ave,1,5,6,201706,2017
60188,2014-06-2017,California,San Francisco,720 San Bruno,4,2,6,201706,2017
60192,11-06-2017,Illinois,Chicago,3300 block of W Douglas Blvd,0,9,9,201706,2017
60196,9-06-2017,Texas,Fort Worth,East Davis Avenue and New York Avenue,2,5,7,201706,2017
60197,8-06-2017,Louisiana,New Orleans,3650 Franklin Ave,0,6,6,201706,2017
60198,6-06-2017,Utah,Sandy,2232 Alta Canyon Drive,3,2,5,201706,2017
60199,5-06-2017,Florida,Orlando,2427 Forsyth Rd,6,0,6,201706,2017
60201,3-06-2017,Louisiana,New Orleans,3717 Tulane Ave,3,2,5,201706,2017
60185,2015-06-2017,New Mexico,La Madera,491 NM 111,5,0,5,201706,2017
60170,30-06-2017,New York,Bronx,1650 Grand Concourse,2,6,8,201706,2017
60145,2019-07-2017,Virginia,Richmond,2300 block of Bethel St,0,5,5,201707,2017
60160,4-07-2017,Virginia,Hampton,500 block of Patterson Ave,1,4,5,201707,2017
60166,1-07-2017,Arkansas,Little Rock,220 W 6th St,0,25,25,201707,2017
60134,30-07-2017,Virginia,Norfolk,1500 block of Azalea Garden Rd,1,5,6,201707,2017
60136,29-07-2017,New York,Buffalo,200 block of Carl St,1,4,5,201707,2017
60137,29-07-2017,North Carolina,Salisbury,115 W Fisher St,2,3,5,201707,2017
60139,27-07-2017,Illinois,Chicago,2000 block of E 71st St,1,4,5,201707,2017
60144,22-07-2017,Ohio,Cincinnati,130 E Clifton Ave,0,5,5,201707,2017
60152,9-07-2017,Virginia,Lawrenceville,500 block of Sturgeon Rd,0,7,7,201707,2017
60154,8-07-2017,Ohio,Cincinnati,9917 Capstan Dr,1,8,9,201707,2017
60158,5-07-2017,Maine,Madison,300 block of Russell Rd,4,1,5,201707,2017
60140,26-07-2017,North Carolina,High Point,2111 E. Green Drive,1,6,7,201707,2017
60100,28-08-2017,New Mexico,Clovis,701 N Main St,2,4,6,201708,2017
60101,27-08-2017,California,Sacramento,7760 24th St,1,4,5,201708,2017
60112,20-08-2017,Illinois,Chicago,11901 S Loomis St,2,5,7,201708,2017
60113,2019-08-2017,Ohio,Cleveland,11143 Superior Ave,1,4,5,201708,2017
60116,13-08-2017,Pennsylvania,Philadelphia,39th St and Melon St,0,5,5,201708,2017
60120,8-08-2017,Illinois,Chicago,1 block of East 37th St,1,6,7,201708,2017
60121,6-08-2017,New York,Bronx,Wickham Ave,0,6,6,201708,2017
60123,6-08-2017,California,Oakland,1000 block of 106th Avenue,0,7,7,201708,2017
60127,4-08-2017,Montana,Lodge Grass,200 block of North Helen Street,3,2,5,201708,2017
60131,1-08-2017,Washington,Toppenish,8000 Block of Lateral C Rd,0,6,6,201708,2017
60132,1-08-2017,California,Fresno,Mariposa St and A St,0,7,7,201708,2017
60078,24-09-2017,Tennessee,Antioch,3890 Pin Hook Rd,1,8,9,201709,2017
60081,23-09-2017,California,Bakersfield,818 Real Rd,1,4,5,201709,2017
60082,23-09-2017,Illinois,Danville,Seminary St and Jackson St,0,5,5,201709,2017
60086,2017-09-2017,Virginia,Petersburg,300 Mistletoe St,1,4,5,201709,2017
60087,2016-09-2017,South Carolina,Columbia,920 Lady Street,0,8,8,201709,2017
60088,13-09-2017,Tennessee,Memphis,1000 block of Morehead St,1,5,6,201709,2017
60084,20-09-2017,Indiana,Gary,4300 block of 23rd Ct,0,5,5,201709,2017
60092,10-09-2017,Texas,Plano,1712 West Spring Creek Parkway,9,1,10,201709,2017
60097,3-09-2017,California,Inglewood,10100 block of S Firmona Ave,2,3,5,201709,2017
60052,22-10-2017,Alabama,Lanett,1606 19th St Sw,2,7,9,201710,2017
60071,1-10-2017,Nevada,Las Vegas,3950 Las Vegas Blvd S,59,441,500,201710,2017
60070,1-10-2017,Kansas,Lawrence,1000 block of Massachusetts St,3,2,5,201710,2017
60067,6-10-2017,Illinois,Chicago,8000 block of S Marshfield,0,5,5,201710,2017
60065,9-10-2017,Texas,Houston,3352 Old Spanish Trail,0,5,5,201710,2017
60057,2018-10-2017,Maryland,Edgewood,2111 Emmorton Park Rd,3,3,6,201710,2017
60050,23-10-2017,California,Clearlake Oaks,13000 block of Anchor Village,2,3,5,201710,2017
60048,27-10-2017,Kentucky,Louisville,1716 Prentice St,0,6,6,201710,2017
60023,24-11-2017,Ohio,Cleveland,11618 Buckeye Rd,1,5,6,201711,2017
60021,30-11-2017,Michigan,Detroit,11000 block of Gunston,1,4,5,201711,2017
60022,24-11-2017,Mississippi,Brookhaven,119 Martin Street,1,6,7,201711,2017
60026,2016-11-2017,Georgia,Columbus,1400 block of 15th Street,0,7,7,201711,2017
60033,11-11-2017,Louisiana,New Orleans,Forstall Street and Burgundy Street,1,5,6,201711,2017
60029,12-11-2017,Indiana,Gary,4601 Melton Rd,0,7,7,201711,2017
60027,2014-11-2017,California,Corning,17357 Stagecoach Rd,6,12,18,201711,2017
60037,5-11-2017,Texas,Sutherland Springs,216 4th St,27,20,47,201711,2017
60044,3-11-2017,Louisiana,Lacombe,27600 block of Mirmar Street,1,4,5,201711,2017
60034,11-11-2017,North Carolina,Fayetteville,2835 Bragg Blvd,1,5,6,201711,2017
60030,12-11-2017,California,Fresno,S Calvin Ave,0,5,5,201711,2017
60012,2015-12-2017,California,Pacoima,13041 Jouett Street,0,5,5,201712,2017
60006,24-12-2017,Alabama,Troy,100 block of Chapman St,1,4,5,201712,2017
60005,24-12-2017,Mississippi,Vicksburg,1111 Mulberry Street,0,5,5,201712,2017
60004,26-12-2017,Florida,Miami,NW 18th Ave and 86th Ter,0,5,5,201712,2017
60000,31-12-2017,Colorado,Littleton (Highlands Ranch),3404 E County Line Rd,2,6,8,201712,2017
70318,28-01-2018,Pennsylvania,Melcroft,1301 Indian Creek Valley Rd,5,0,5,201801,2018
70322,23-01-2018,Kentucky,Benton,416 High School Rd,2,14,16,201801,2018
70316,28-01-2018,Indiana,Indianapolis,1313 N Sherman Dr,2,3,5,201801,2018
70328,2014-01-2018,Alabama,Eutaw,809 Mesopotamia St,1,4,5,201801,2018
70327,2015-01-2018,Florida,Alachua,14223 NW 156th Pl,0,5,5,201801,2018
70334,5-01-2018,Mississippi,Hattiesburg,6168 US 49,0,6,6,201801,2018
70320,27-01-2018,California,Los Angeles,243 East 119th St,0,5,5,201801,2018
70330,12-01-2018,Tennessee,Nashville,2614 Jenkins Ct,3,2,5,201801,2018
70332,7-01-2018,Alabama,Union Springs,US-29,1,5,6,201801,2018
70314,3-02-2018,Ohio,Cleveland (Garfield Heights),11321 Broadway Ave,1,5,6,201802,2018
70313,5-02-2018,Colorado,Colorado Springs,4225 Galley Rd,2,4,6,201802,2018
70312,7-02-2018,Florida,Lake Worth (Lantana),I-95 and Lantana Ave,3,3,6,201802,2018
70311,10-02-2018,Kentucky,Paintsville,413 Mill St,5,0,5,201802,2018
70309,13-02-2018,Louisiana,New Orleans,5400 block of Andry St,2,3,5,201802,2018
70308,2014-02-2018,Florida,Pompano Beach (Parkland),5901 Pine Island Rd,17,17,34,201802,2018
70306,2017-02-2018,Tennessee,Memphis,3188 N Watkins Ave,0,5,5,201802,2018
70305,2017-02-2018,Kansas,Kansas City,1615 Minnesota,1,7,8,201802,2018
70304,2018-02-2018,Texas,San Antonio,2893 Cinema Ridge,0,5,5,201802,2018
70302,26-02-2018,Michigan,Detroit,22700 Fenkell Ave,5,0,5,201802,2018
70310,11-02-2018,Michigan,Detroit,19432 Lamont St,4,3,7,201802,2018
70289,2017-03-2018,Kentucky,Louisville,2928 W Kentucky St,0,7,7,201803,2018
70295,11-03-2018,Michigan,Saginaw,Cumberland Ave and Hess St,1,4,5,201803,2018
70294,11-03-2018,Indiana,South Bend,800 block of E Dayton St,0,6,6,201803,2018
70288,21-03-2018,California,San Francisco,949 Geneva Ave,1,5,6,201803,2018
70284,31-03-2018,New Jersey,Asbury Park,Atlantic Ave and Monmouth Ave,0,5,5,201803,2018
70298,4-03-2018,Illinois,Rockford,426 Howard Ave,1,4,5,201803,2018
70282,1-04-2018,Alabama,Mobile,3556 Halls Mill Rd,1,4,5,201804,2018
70283,1-04-2018,Michigan,Saginaw,600 block of Yale St,0,5,5,201804,2018
70274,2015-04-2018,Louisiana,Shreveport,6956 Jewella Ave,0,6,6,201804,2018
70273,2018-04-2018,North Carolina,Asheville,73 Hansel Ave,4,3,7,201804,2018
70272,20-04-2018,California,San Francisco,3rd Street and Quesada Ave,1,5,6,201804,2018
70270,22-04-2018,Louisiana,New Orleans,1900 block of St Roch Ave,1,5,6,201804,2018
70269,22-04-2018,Tennessee,Antioch,3571 Murfreesboro Pike,4,3,7,201804,2018
70265,28-04-2018,North Carolina,Maxton,Modest Rd,0,5,5,201804,2018
70236,20-05-2018,Mississippi,Hazlehurst,513 Monticello St,1,7,8,201805,2018
70237,2018-05-2018,Texas,Santa Fe,16000 Hwy 6,10,13,23,201805,2018
70258,1-05-2018,Louisiana,New Orleans,3200 block of Saint Claude Ave,0,5,5,201805,2018
70257,2-05-2018,New York,Brooklyn,333 Bristol St,1,4,5,201805,2018
70256,2-05-2018,Minnesota,Minneapolis,2400 block of Ogema Place,0,5,5,201805,2018
70255,2-05-2018,Illinois,Chicago,3500 block of W Grenshaw St,1,4,5,201805,2018
70252,5-05-2018,Georgia,Columbus,4944 Sentry Street,0,5,5,201805,2018
70250,6-05-2018,Tennessee,Memphis,499 North Watkins,2,4,6,201805,2018
70249,7-05-2018,California,San Diego,15th St and J St,0,5,5,201805,2018
70246,11-05-2018,Oklahoma,Talihina,2nd St and Dallas St,1,4,5,201805,2018
70243,12-05-2018,Nebraska,Omaha,3201 Decatur St,0,6,6,201805,2018
70241,13-05-2018,California,Stockton,2436 Belleview St,3,2,5,201805,2018
70238,2016-05-2018,Texas,Ponder,610 Lone Star Park Ln,5,1,6,201805,2018
70231,31-05-2018,South Carolina,Timmonsville,544 Chaney Grove Rd,3,2,5,201805,2018
70180,30-06-2018,Georgia,Ashburn,800 Block of W. Washington,1,6,7,201806,2018
70181,30-06-2018,Maryland,Baltimore,4000 block of Penhurst Ave,0,6,6,201806,2018
70182,30-06-2018,New Jersey,Jersey City,Lexington Ave and John F Kennedy Blvd,0,5,5,201806,2018
70216,11-06-2018,Florida,Orlando,4932 Eaglesmere Dr,5,1,6,201806,2018
70227,3-06-2018,Texas,Dallas,4500 Spring Ave,0,5,5,201806,2018
70225,9-06-2018,Pennsylvania,Philadelphia,2000 block of 20th St,1,4,5,201806,2018
70222,10-06-2018,Illinois,Chicago,6400 block of S Eberhart Ave,1,5,6,201806,2018
70221,10-06-2018,Florida,Bradenton,5627 14th St W,1,5,6,201806,2018
70220,10-06-2018,Illinois,Aurora,300 block of W Park Ave,0,7,7,201806,2018
70219,10-06-2018,Indiana,Indianapolis (Lawrence),4745 N Richardt Ave,1,4,5,201806,2018
70218,10-06-2018,California,Valley Village,12719 Tiara St,0,6,6,201806,2018
70183,28-06-2018,Maryland,Annapolis,888 Bestgate Rd,5,0,5,201806,2018
70229,2-06-2018,Nebraska,Omaha,S 11th St and Farnam St,1,6,7,201806,2018
70212,2014-06-2018,California,Tracy,West 6th Street,1,4,5,201806,2018
70210,2014-06-2018,California,Union City,32992 Mission Blvd,0,5,5,201806,2018
70206,2017-06-2018,New Jersey,Trenton,635 S Clinton Ave,1,19,20,201806,2018
70204,2018-06-2018,Illinois,Chicago,1300 block of S Loomis St,2,3,5,201806,2018
70201,20-06-2018,California,Modesto,2300 block of West Hatch Road,0,5,5,201806,2018
70195,23-06-2018,Illinois,Chicago,100 block of East 51st St,1,4,5,201806,2018
70193,24-06-2018,Ohio,Sandusky,1504 Milan Rd,0,5,5,201806,2018
70188,24-06-2018,North Carolina,Sanford,109 S Steele St,1,6,7,201806,2018
70187,25-06-2018,Illinois,Chicago,3900 block of S Vincennes Ave,0,6,6,201806,2018
70211,2014-06-2018,New York,Buffalo,Marigold Ave,1,4,5,201806,2018
70230,2-06-2018,New York,Buffalo,Strauss Street,0,5,5,201806,2018
70139,29-07-2018,Arizona,Phoenix,2501 E Van Buren St,1,4,5,201807,2018
70135,31-07-2018,California,Gardena,1212 West 135th Street,2,3,5,201807,2018
70141,28-07-2018,Louisiana,New Orleans,3400 S Claiborne Ave,3,7,10,201807,2018
70145,26-07-2018,Ohio,Cleveland,18416 St Clair Ave,1,6,7,201807,2018
70143,27-07-2018,Texas,Robstown,603 East Ave J,5,0,5,201807,2018
70142,28-07-2018,California,Los Angeles,8801 S Vermont Ave,2,4,6,201807,2018
70179,1-07-2018,Illinois,Chicago,3400 block of W Walnut Ave,0,6,6,201807,2018
70174,5-07-2018,Ohio,Lima,1440 Bellefontaine Ave,1,5,6,201807,2018
70173,5-07-2018,Virginia,Virginia Beach,1800 block of Atlantic Ave,0,6,6,201807,2018
70172,5-07-2018,California,Los Angeles,1600 block of W. 2nd Street,3,3,6,201807,2018
70169,7-07-2018,Alabama,Wetumpka,135 Granite Way,3,2,5,201807,2018
70167,8-07-2018,Alabama,Brandon,565 US-80,0,6,6,201807,2018
70166,9-07-2018,Florida,Orlando,Southland Blvd and Orange Blossom Trail,1,4,5,201807,2018
70165,9-07-2018,Delaware,Wilmington,2709 Ferris Rd,5,0,5,201807,2018
70162,12-07-2018,Tennessee,Memphis,3678 Powers Rd,0,5,5,201807,2018
70159,2015-07-2018,Tennessee,Chattanooga,1400 Cowart St,0,5,5,201807,2018
70157,2016-07-2018,Pennsylvania,Philadelphia,2100 block of N 4th St,1,4,5,201807,2018
70156,2016-07-2018,Florida,Palm Beach Gardens (Riviera Beach),2100 block of W 28th St,2,4,6,201807,2018
70155,2016-07-2018,District of Columbia,Washington,300 block of 53rd St NE,1,4,5,201807,2018
70152,20-07-2018,Washington,Sunnyside,500 block of S 15th St,1,4,5,201807,2018
70176,3-07-2018,Missouri,Saint Louis,1700 block of Billups Ave,1,5,6,201807,2018
70151,21-07-2018,Illinois,Chicago,3100 block of W Fulton St,2,5,7,201807,2018
70149,23-07-2018,Illinois,Chicago,6400 block of S May St,0,5,5,201807,2018
70147,26-07-2018,Texas,Dallas,3019 South Blvd,0,6,6,201807,2018
70100,31-08-2018,Colorado,Aurora,1900 block of Peoria St,2,3,5,201808,2018
70132,4-08-2018,Missouri,Kansas City,E 18th St and Highland Ave,0,6,6,201808,2018
70131,4-08-2018,Nevada,Las Vegas,3400 block of Coran Ln,0,6,6,201808,2018
70128,5-08-2018,Illinois,Chicago,1 block of N Leclaire Ave,1,4,5,201808,2018
70127,5-08-2018,Illinois,Chicago,1300 block of W 76th St,0,8,8,201808,2018
70126,5-08-2018,Illinois,Chicago,1300 block of S Millard Ave,1,5,6,201808,2018
70125,8-08-2018,Pennsylvania,Philadelphia,North 12th Street and West Huntingdon Street,2,4,6,201808,2018
70120,11-08-2018,California,San Francisco,Geneva St and Mission St,1,4,5,201808,2018
70117,12-08-2018,California,Clearlake,4786 Yarrington Ct,4,1,5,201808,2018
70116,2014-08-2018,Pennsylvania,Wyncote,1000 S Easton Rd,0,5,5,201808,2018
70115,2015-08-2018,South Carolina,Greenwood,104 Mimosa Ct,0,5,5,201808,2018
70114,2017-08-2018,Illinois,Chicago,1600 block of W 65th St,0,7,7,201808,2018
70112,2019-08-2018,Illinois,Chicago,7400 block of S Dante Ave,0,5,5,201808,2018
70110,20-08-2018,Tennessee,Jackson,60 Heritage Square,1,4,5,201808,2018
70105,25-08-2018,Tennessee,Nashville,1564 9th Ave N,1,4,5,201808,2018
70104,25-08-2018,Virginia,Richmond,4 N 18th St,0,5,5,201808,2018
70103,26-08-2018,Florida,Jacksonville,2 Independent Dr,3,9,12,201808,2018
70102,26-08-2018,Texas,Wichita Falls,2400 Sheppard Access Rd,1,4,5,201808,2018
70099,1-09-2018,Ohio,Cleveland,3232 Lakeside Ave East,1,7,8,201809,2018
70096,2-09-2018,California,San Bernardino,1277 East Lynwood Drive,0,8,8,201809,2018
70094,2-09-2018,Alabama,Birmingham,500 23rd St S,0,7,7,201809,2018
70090,6-09-2018,Ohio,Cincinnati,511 Walnut St,4,2,6,201809,2018
70086,9-09-2018,Alabama,Auburn,224 W Magnolia St,1,4,5,201809,2018
70085,10-09-2018,Tennessee,Memphis,140 Lt George W Lee Ave,0,5,5,201809,2018
70067,29-09-2018,Florida,Orlando,1700 block of 24th St,1,4,5,201809,2018
70077,2019-09-2018,Pennsylvania,Masontown,1 E Church St,1,4,5,201809,2018
70076,2019-09-2018,Wisconsin,Middleton,1850 Deming Way,1,4,5,201809,2018
70075,20-09-2018,New York,Syracuse,1317 Midland Ave,0,5,5,201809,2018
70074,20-09-2018,Maryland,Aberdeen,1501 Perryman Rd,4,3,7,201809,2018
70070,23-09-2018,California,Bakersfield,2600 block of Chandler Court,1,4,5,201809,2018
70069,24-09-2018,Tennessee,Memphis,1528 Ragan St,3,2,5,201809,2018
70081,2017-09-2018,Maryland,Silver Spring,123 Amberleigh Dr,4,1,5,201809,2018
70083,12-09-2018,California,Bakersfield,660 Manwell Blvd,6,0,6,201809,2018
70041,27-10-2018,Tennessee,Memphis,4275 Lady Slipper Ln,0,5,5,201810,2018
70038,30-10-2018,California,Los Angeles,65th Place and Vermont Avenue,0,5,5,201810,2018
70064,3-10-2018,Pennsylvania,Philadelphia,5101 Germantown Ave,1,4,5,201810,2018
70063,3-10-2018,South Carolina,Florence,932 Ashton Dr,2,6,8,201810,2018
70060,6-10-2018,California,Oakland,Williams St and Telegraph Ave,0,6,6,201810,2018
70055,12-10-2018,South Carolina,Spartanburg,1620 John B White Sr Blvd,0,6,6,201810,2018
70053,13-10-2018,Texas,Taft,511 Wilburn St,4,1,5,201810,2018
70049,2015-10-2018,Tennessee,Columbia,1075 Carters Creek Pike,5,0,5,201810,2018
70046,21-10-2018,Florida,Jacksonville,900 block of A Philip Randolph Blvd,1,5,6,201810,2018
70045,22-10-2018,Illinois,Chicago,9231 S Cottage Grove Av,0,6,6,201810,2018
70044,24-10-2018,Illinois,Chicago,6200 block of S King Dr,0,5,5,201810,2018
70042,27-10-2018,Pennsylvania,Pittsburgh,5898 Wilkins Ave,11,7,18,201810,2018
70039,29-10-2018,California,Riverside,3252 Mission Inn Ave,0,7,7,201810,2018
70037,30-10-2018,California,Vallejo,Woodrow Ave and Reis Ave,2,3,5,201810,2018
70030,7-11-2018,California,Thousand Oaks,99 Rolling Oaks Dr,13,2,15,201811,2018
70035,1-11-2018,Missouri,Springfield,906 E Locust St,3,2,5,201811,2018
70027,13-11-2018,New Mexico,Gallup,CR 1 and Defiance Draw Rd,4,1,5,201811,2018
70033,2-11-2018,Florida,Tallahassee,1950 Thomasville Rd,3,4,7,201811,2018
70031,3-11-2018,New York,Watertown,136 Franklin St,0,5,5,201811,2018
70024,2018-11-2018,California,Los Angeles (Watts),95th St and Defiance Ave,1,4,5,201811,2018
70022,2019-11-2018,Colorado,Denver,1200 21st Street,1,4,5,201811,2018
70020,22-11-2018,Indiana,Fort Wayne,6100 block of Downingtown Dr,3,2,5,201811,2018
70019,23-11-2018,Florida,Miami,5801 NW 27th Ave,2,5,7,201811,2018
70034,1-11-2018,Minnesota,Minneapolis,3400 block of Girard Ave N,0,5,5,201811,2018
70013,8-12-2018,New York,Corona (Queens),89-25 130th St,0,5,5,201812,2018
70014,1-12-2018,Florida,Miami,NW Fifth Ave and NW Eighth St,0,5,5,201812,2018
70007,2015-12-2018,Florida,Miami,239 NW 16th St,0,5,5,201812,2018
70006,2018-12-2018,Maryland,Baltimore,3942 Park Heights Ave,0,5,5,201812,2018
70004,23-12-2018,Missouri,Springfield,1042 W College St,1,6,7,201812,2018
70002,28-12-2018,Missouri,Saint Charles,150 Whetstone Dr,4,1,5,201812,2018
70000,31-12-2018,Ohio,Cleveland,4462 Denison Ave,3,2,5,201812,2018
70012,8-12-2018,California,Inglewood,801 S Inglewood Ave,0,5,5,201812,2018
80269,24-01-2019,Georgia,Rockmart,319 Williamson St,4,1,5,201901,2019
80262,28-01-2019,Texas,Houston,7815 Harding St,2,5,7,201901,2019
80263,27-01-2019,Alabama,Birmingham,Avenue O and Warrior Rd,0,5,5,201901,2019
80265,26-01-2019,Indiana,Indianapolis,2957 N Sherman Dr,0,5,5,201901,2019
80267,26-01-2019,Louisiana,Gonzales,42350 Church Point Rd,5,0,5,201901,2019
80268,24-01-2019,Pennsylvania,State College,1450 S Atherton St,4,1,5,201901,2019
80270,23-01-2019,Florida,Sebring,1901 US 27 S,5,0,5,201901,2019
80284,4-01-2019,California,Torrance,22501 Hawthorne Blvd,3,4,7,201901,2019
80274,2019-01-2019,South Carolina,Gaffney,1435 Wilcox Ave,1,4,5,201901,2019
80276,2019-01-2019,Florida,Jacksonville,11445 Brian Lakes Drive,3,2,5,201901,2019
80278,2016-01-2019,Florida,Jacksonville,Emerson St and Spring Park Rd,1,5,6,201901,2019
80280,2015-01-2019,Arkansas,Little Rock,5420 Baseline Rd,1,4,5,201901,2019
80281,13-01-2019,Arizona,Phoenix,2445 E Van Buren St,1,5,6,201901,2019
80283,4-01-2019,Virginia,Hurt,3197 Shula Dr,3,2,5,201901,2019
80273,2019-01-2019,Texas,Houston,7041 Sherman St,3,2,5,201901,2019
80287,1-01-2019,South Carolina,Columbia,1709 Decker Blvd,0,5,5,201901,2019
80288,1-01-2019,Florida,Tallahassee,2020 W Pensacola St,0,5,5,201901,2019
80244,21-02-2019,Maryland,Baltimore,500 block of Bloom St,1,4,5,201902,2019
80249,2017-02-2019,Indiana,Evansville,664 E Illinois St,0,5,5,201902,2019
80251,2016-02-2019,Mississippi,Clinton,1214 Foxhill Dr,5,0,5,201902,2019
80252,2015-02-2019,Illinois,Aurora,641 Archer Ave,6,6,12,201902,2019
80253,11-02-2019,Texas,Livingston,3628 FM 3126,5,0,5,201902,2019
80257,4-02-2019,District of Columbia,Washington,2341 Pennsylvania Ave SE,0,5,5,201902,2019
80260,3-02-2019,Illinois,Chicago,938 E 75th St,2,5,7,201902,2019
80250,2017-02-2019,Louisiana,New Orleans,Tulane Ave and Elk Pl,1,5,6,201902,2019
80224,31-03-2019,South Carolina,North Charleston,1900 block of Jacksonville Rd,0,7,7,201903,2019
80222,31-03-2019,Illinois,Chicago,500 block of N Hamlin Ave,1,4,5,201903,2019
80223,31-03-2019,Georgia,Atlanta,3041 Landrum Dr SW,1,4,5,201903,2019
80226,25-03-2019,Nevada,North Las Vegas,2400 block of W San Miguel St,0,5,5,201903,2019
80240,3-03-2019,Illinois,Chicago,2900 block of E 79th St,0,6,6,201903,2019
80228,24-03-2019,Arizona,Phoenix,2202 W McDowell Rd,0,7,7,201903,2019
80229,2019-03-2019,Arizona,Phoenix,8526 N 27th Ave,2,4,6,201903,2019
80234,2015-03-2019,Alabama,Mobile,515 Dauphin Island Pkwy,2,4,6,201903,2019
80238,10-03-2019,Colorado,Denver,15th St and Market St,1,4,5,201903,2019
80227,24-03-2019,California,San Francisco,1300 Fillmore St,1,5,6,201903,2019
80241,2-03-2019,Arkansas,Pine Bluff,723 East 25th Ave,1,4,5,201903,2019
80190,28-04-2019,Tennessee,Nashville,1407 Dr DB Todd Jr Blvd,0,7,7,201904,2019
80192,28-04-2019,Maryland,Baltimore,2544 Edmondson Ave,1,7,8,201904,2019
80196,27-04-2019,California,Los Angeles,700 N San Fernando Rd,0,6,6,201904,2019
80198,20-04-2019,Tennessee,Memphis,761 Chestnut Ave,0,5,5,201904,2019
80189,30-04-2019,North Carolina,Charlotte,9214 South Library Ln,2,4,6,201904,2019
80210,11-04-2019,California,Los Angeles,E 103rd St and S Main St,1,4,5,201904,2019
80213,7-04-2019,North Carolina,Winston Salem (Winston-salem),515 N Cherry St,0,7,7,201904,2019
80214,7-04-2019,Delaware,Wilmington,940 N Pine St,0,6,6,201904,2019
80217,6-04-2019,Illinois,Chicago,6300 block of S Seeley Ave,0,6,6,201904,2019
80219,4-04-2019,Georgia,Stockbridge,300 block of Eagle Ct,3,2,5,201904,2019
80221,2-04-2019,Kentucky,Covington,300 block of 13th St,0,5,5,201904,2019
80209,11-04-2019,Arizona,Phoenix,7112 W Minnezona Ave,3,2,5,201904,2019
80156,25-05-2019,Oklahoma,Oklahoma City,N Kelley Ave and NE 26th St,0,5,5,201905,2019
80154,25-05-2019,Virginia,Chesapeake,Holly Cove Dr and Schooner Trail,1,9,10,201905,2019
80153,25-05-2019,Michigan,Detroit,3400 block of Devonshire,3,2,5,201905,2019
80152,25-05-2019,New Jersey,Trenton,225 Brunswick Ave,0,9,9,201905,2019
80144,29-05-2019,Texas,Cleveland,26311 TX-321,3,2,5,201905,2019
80148,27-05-2019,New Jersey,Trenton,100 block of Walnut St,1,5,6,201905,2019
80147,27-05-2019,District of Columbia,Washington,1200 block of Sumner Rd SE,0,5,5,201905,2019
80143,30-05-2019,Illinois,Robbins,14000 block of Grace Ave,0,5,5,201905,2019
80158,20-05-2019,Louisiana,Alexandria,1900 block of Bacon Street,1,4,5,201905,2019
80150,26-05-2019,Virginia,La Crosse,800 block of Alvis Road,0,5,5,201905,2019
80160,2019-05-2019,Oregon,Portland,226 SE Madison St,0,5,5,201905,2019
80142,31-05-2019,Virginia,Virginia Beach,2405 Courthouse Drive,13,4,17,201905,2019
80162,2018-05-2019,Alabama,Atmore,100 Martin Luther King Avenue,1,8,9,201905,2019
80183,4-05-2019,California,Stockton,5105 Holiday Dr,1,4,5,201905,2019
80186,3-05-2019,Maryland,Baltimore,1900 block of Ramsay St,0,5,5,201905,2019
80181,4-05-2019,Missouri,Saint Louis,Union Blvd and Northland Ave,1,4,5,201905,2019
80180,5-05-2019,California,Oceano,1001 Cabrillo Hwy,0,6,6,201905,2019
80179,5-05-2019,New Jersey,North Bergen,2033 45th Street,1,4,5,201905,2019
80178,7-05-2019,Colorado,Littleton (Highlands Ranch),8773 S Ridgeline Blvd,1,8,9,201905,2019
80161,2018-05-2019,Mississippi,Cascilla,700 Leverette Ln,1,4,5,201905,2019
80175,10-05-2019,Pennsylvania,Philadelphia,1900 block of N Croskey St,0,5,5,201905,2019
80173,13-05-2019,Missouri,Saint Louis,4047 Shreve Ave,4,1,5,201905,2019
80167,2018-05-2019,North Carolina,Winston Salem (Winston-salem),4252 Cody Drive,2,4,6,201905,2019
80164,2018-05-2019,California,Long Beach,1616 West Pacific Coast Highway,1,4,5,201905,2019
80163,2018-05-2019,Indiana,Muncie,2410 W. Euclid Ave,1,6,7,201905,2019
80176,10-05-2019,Missouri,Saint Louis,4000 block of Ashland Ave,0,6,6,201905,2019
80104,23-06-2019,California,San Jose,568 Habbitts Court,5,0,5,201906,2019
80101,27-06-2019,Georgia,Atlanta,600 block of Parkway Dr,0,7,7,201906,2019
80100,28-06-2019,Minnesota,Saint Paul,909 Desoto St,0,5,5,201906,2019
80098,28-06-2019,Georgia,Atlanta,Ira St and Bass St SW,0,7,7,201906,2019
80095,29-06-2019,Louisiana,Baton Rouge,7132 Florida Blvd,0,7,7,201906,2019
80094,29-06-2019,Illinois,Chicago,2400 block of W Jackson Blvd,0,5,5,201906,2019
80091,30-06-2019,New York,Bay Shore,Farragut Ave,0,6,6,201906,2019
80089,30-06-2019,California,Yucaipa,12700 block of California St,0,5,5,201906,2019
80105,23-06-2019,Indiana,South Bend,1150 E Mishawaka Ave,1,10,11,201906,2019
80097,28-06-2019,Connecticut,Hamden,937 Choate Ave,0,5,5,201906,2019
80106,23-06-2019,Ohio,Columbus,1767 Genessee Ave,0,5,5,201906,2019
80116,20-06-2019,Pennsylvania,Allentown,343 Hamilton St,0,10,10,201906,2019
80114,21-06-2019,California,Santa Maria,519  West Taylor St,5,0,5,201906,2019
80111,22-06-2019,Maryland,Baltimore,800 block of N Port St,1,4,5,201906,2019
80140,1-06-2019,Georgia,Macon,Suzanne Dr and Robinson Dr,2,4,6,201906,2019
80139,1-06-2019,Georgia,Atlanta,12 Broad Street,0,5,5,201906,2019
80135,1-06-2019,South Carolina,Allendale,473 Main St S,0,5,5,201906,2019
80130,8-06-2019,Washington,White Swan,5151 Medicine Valley Rd,5,2,7,201906,2019
80132,7-06-2019,Texas,Austin,8220 TX-71,0,5,5,201906,2019
80121,2016-06-2019,Kentucky,Louisville,Dixie Highway and Ormsby Ave,1,6,7,201906,2019
80120,2016-06-2019,Pennsylvania,Philadelphia,2910 S 70th St,1,5,6,201906,2019
80119,2017-06-2019,Tennessee,Memphis,2872 Coach Dr,0,5,5,201906,2019
80117,2018-06-2019,New Jersey,Newark,700 block of Dr Martin Luther King Jr Blvd,1,4,5,201906,2019
80115,21-06-2019,California,Richmond,700 block of 14th St,0,5,5,201906,2019
80122,2016-06-2019,Iowa,Des Moines,1200 block of Sampson St,0,6,6,201906,2019
80053,27-07-2019,New York,Brooklyn,1555 Linden Blvd,1,11,12,201907,2019
80046,30-07-2019,Ohio,Columbus,1280 E Long St,0,5,5,201907,2019
80048,28-07-2019,Pennsylvania,Philadelphia,2600 block of Carroll St,1,5,6,201907,2019
80049,28-07-2019,Wisconsin,Chippewa Falls (Lafayette),16964 54th Ave,6,2,8,201907,2019
80055,25-07-2019,California,Canoga Park,21901 Roscoe Boulevard,4,2,6,201907,2019
80047,28-07-2019,California,Gilroy,7050 Miller Ave,4,17,21,201907,2019
80066,13-07-2019,Illinois,Chicago,7900 block of S Loomis Blvd,1,4,5,201907,2019
80078,5-07-2019,Illinois,Chicago,1600 block of E 67th St,0,5,5,201907,2019
80060,20-07-2019,Illinois,Chicago,2401 N Lake Shore Dr,0,7,7,201907,2019
80077,5-07-2019,Massachusetts,Boston,Maple St,0,6,6,201907,2019
80085,3-07-2019,Texas,Katy,5507 Everhart Manor Ln,2,3,5,201907,2019
80071,7-07-2019,Missouri,Saint Louis,N Tucker Blvd and Convention Plaza,0,5,5,201907,2019
80067,13-07-2019,Pennsylvania,Philadelphia,5433 Lansdowne Ave,0,7,7,201907,2019
80070,7-07-2019,Michigan,Flint,Clio Rd and Myrtle St,0,6,6,201907,2019
80076,6-07-2019,Missouri,Saint Louis,1921 Chambers Rd,5,0,5,201907,2019
80007,31-08-2019,Illinois,Chicago,7100 block of S Paulina St,2,3,5,201908,2019
80011,31-08-2019,Texas,Odessa,8250 TX-191,8,23,31,201908,2019
80015,30-08-2019,Alabama,Mobile,1621 Virginia St,0,6,6,201908,2019
80018,25-08-2019,New Mexico,Hobbs,1700 block of East Bond St,3,4,7,201908,2019
80020,24-08-2019,Maryland,Temple Hills (Camp Springs),6200 block of Maxwell Dr,0,7,7,201908,2019
80021,23-08-2019,Texas,Houston,4900 block of Southwind St,3,2,5,201908,2019
80028,2017-08-2019,Texas,Houston,12500 block of Mylla St,0,6,6,201908,2019
80030,2015-08-2019,Alabama,Montgomery,847 N University Dr,2,3,5,201908,2019
80032,13-08-2019,Washington,Tacoma,E 38th St and E Roosevelt Ave,2,3,5,201908,2019
80034,11-08-2019,Illinois,Chicago,3500 block of W Lake St,0,6,6,201908,2019
80040,4-08-2019,Illinois,Chicago,1800 S Kildare Ave,1,7,8,201908,2019
80042,4-08-2019,Ohio,Dayton,419 E 5th St,10,17,27,201908,2019
80043,4-08-2019,Illinois,Chicago,2900 block of W Roosevelt Rd,0,7,7,201908,2019
80044,3-08-2019,Texas,El Paso,7101 Gateway Blvd,22,24,46,201908,2019
80045,2-08-2019,Virginia,Suffolk,200 block of N Broad St,2,3,5,201908,2019
80029,2015-08-2019,Pennsylvania,Philadelphia,5800 block of N 15th St,0,5,5,201908,2019
80031,2014-08-2019,Pennsylvania,Philadelphia,3716 N 15th St,0,6,6,201908,2019
80005,1-09-2019,Alabama,Valley,502 Boulevard,0,7,7,201909,2019
80001,2-09-2019,Alabama,Elkmont,25019 Ridge Road,5,0,5,201909,2019
